36 36 36 1 2 36 36 36 36 36 36 36 36 36 36 36 36 36 36 36
36 36 36 1 2 36 36 36 36 36 36 36 36 36 36 36 36 36 36 36
36 36 36 1 2 36 36 36 36 36 36 36 36 36 36 36 36 36 36 36
36 36 59 1 2 37 60 36 36 36 36 36 36 36 36 36 36 36 36 36
36 36 16 1 2 38 49 36 36 36 36 36 36 36 36 36 36 36 36 36
36 36 16 1  2 1 1 1 1 1 1 1 1 1 1 1 1 1 1 1
36 36 16 1 3 3 49 36 36 36 36 36 36 36 36 36 36 36 36 36
36 36 57 1 3 2 55 62 36 36 36 36 36 36 36 36 36 36 36 36 36
36 36 36 1 3 2 36 36 36 36 36 36 36 36 36 36 36 36 36 36 36
36 36 36 1 3 2 36 36 36 36 36 36 36 36 36 36 36 36 36 36 36
36 36 36 1 3 2 36 36 36 36 36 36 36 36 36 36 36 36 36 36 36


1 = sol pavé herbe gauche
2 = sol pabé herbe droite
3 = sol normal